"at" = (/obj/item/flashlight/lantern{anchored = 1; icon_state = "lantern-on"; on = 1},/turf/open/floor/plating/dirt/jungle,/area/ruin/lavaland/powered/animal_hospital)
"bL" = (/turf/open/floor/wood/damturf/broken6,/area/ruin/lavaland/powered/animal_hospital)
"cu" = (/obj/structure/bed/badhaybed,/obj/machinery/light/small{dir = 8},/turf/open/floor/plating/dirt/jungle,/area/ruin/lavaland/powered/animal_hospital)
"cB" = (/obj/structure/sink/puddle,/turf/open/floor/grass{initial_gas_mix = "o2=14;n2=23;TEMP=300"},/area/ruin/lavaland/powered/animal_hospital)
"fo" = (/mob/living/simple_animal/cow{name = "Jesse"},/obj/machinery/light/small{dir = 4},/turf/open/floor/plating/dirt/jungle,/area/ruin/lavaland/powered/animal_hospital)
"fF" = (/turf/template_noop,/area/template_noop)
"gI" = (/turf/open/floor/wood/damturf/broken4,/area/ruin/lavaland/powered/animal_hospital)
"gS" = (/obj/item/stack/sheet/hay{pixel_x = -8; pixel_y = 8},/obj/item/flashlight/lantern{anchored = 1; icon_state = "lantern-on"; on = 1},/turf/open/floor/wood,/area/ruin/lavaland/powered/animal_hospital)
"ha" = (/obj/item/card/id,/obj/item/pickaxe,/obj/item/storage/backpack/satchel,/obj/item/tank/internals/emergency_oxygen,/turf/open/water/jungle,/area/ruin/lavaland/powered/animal_hospital)
"hk" = (/obj/structure/fluff/railing{dir = 4},/obj/item/clothing/shoes/workboots/mining{pixel_y = -3},/obj/item/clothing/under/rank/cargo/miner/lavaland{pixel_y = 8; pixel_x = -8},/turf/open/floor/plating/dirt/jungle,/area/ruin/lavaland/powered/animal_hospital)
"js" = (/turf/open/floor/wood,/area/ruin/lavaland/powered/animal_hospital)
"kt" = (/obj/structure/flora/ausbushes/fullgrass,/turf/open/floor/grass{initial_gas_mix = "o2=14;n2=23;TEMP=300"},/area/ruin/lavaland/powered/animal_hospital)
"lw" = (/obj/structure/flora/ausbushes/lavendergrass,/turf/open/floor/plating/dirt/jungle,/area/ruin/lavaland/powered/animal_hospital)
"lE" = (/obj/structure/mineral_door/woodrustic,/obj/structure/barricade/wooden/crude,/turf/open/floor/wood,/area/ruin/lavaland/powered/animal_hospital)
"mt" = (/obj/structure/flora/ausbushes/reedbush,/turf/open/water/jungle,/area/ruin/lavaland/powered/animal_hospital)
"my" = (/turf/closed/wall/mineral/wood,/area/ruin/lavaland/powered/animal_hospital)
"nq" = (/obj/structure/fans/tiny/invisible,/obj/structure/mineral_door/woodrustic,/turf/open/floor/wood,/area/ruin/lavaland/powered/animal_hospital)
"oA" = (/obj/item/stack/sheet/hay{pixel_y = -8; pixel_x = -8},/obj/item/stack/sheet/hay,/turf/open/floor/wood/damturf/broken3,/area/ruin/lavaland/powered/animal_hospital)
"pA" = (/obj/structure/closet/crate/plaswood,/obj/item/reagent_containers/pill/mutationmootant,/obj/item/reagent_containers/pill/mutationmootant,/turf/open/floor/wood,/area/ruin/lavaland/powered/animal_hospital)
"pP" = (/obj/structure/reagent_dispensers/watertank,/turf/open/floor/plating/dirt/jungle,/area/ruin/lavaland/powered/animal_hospital)
"qM" = (/obj/structure/flora/ausbushes/grassybush,/turf/open/floor/grass{initial_gas_mix = "o2=14;n2=23;TEMP=300"},/area/ruin/lavaland/powered/animal_hospital)
"sa" = (/obj/item/flashlight/lantern{anchored = 1; icon_state = "lantern-on"; on = 1},/turf/open/floor/wood,/area/ruin/lavaland/powered/animal_hospital)
"tX" = (/obj/structure/flora/ausbushes/lavendergrass,/obj/machinery/light,/turf/open/floor/grass{initial_gas_mix = "o2=14;n2=23;TEMP=300"},/area/ruin/lavaland/powered/animal_hospital)
"vJ" = (/mob/living/simple_animal/cow,/turf/open/floor/grass{initial_gas_mix = "o2=14;n2=23;TEMP=300"},/area/ruin/lavaland/powered/animal_hospital)
"wt" = (/obj/machinery/light,/turf/open/floor/grass{initial_gas_mix = "o2=14;n2=23;TEMP=300"},/area/ruin/lavaland/powered/animal_hospital)
"xH" = (/obj/effect/mapping_helpers/no_lava,/turf/open/floor/plating/asteroid/basalt/lava_land_surface,/area/lavaland/surface/outdoors)
"yt" = (/obj/machinery/iv_drip/feeding_tube,/turf/open/floor/wood/damturf/broken6,/area/ruin/lavaland/powered/animal_hospital)
"Af" = (/obj/structure/flora/ausbushes/lavendergrass,/turf/open/floor/grass{initial_gas_mix = "o2=14;n2=23;TEMP=300"},/area/ruin/lavaland/powered/animal_hospital)
"Ai" = (/turf/open/floor/plating/dirt/jungle,/area/ruin/lavaland/powered/animal_hospital)
"AK" = (/mob/living/simple_animal/cow{name = "Mako"},/turf/open/floor/plating/dirt/jungle,/area/ruin/lavaland/powered/animal_hospital)
"Be" = (/obj/structure/mineral_door/woodrustic,/turf/open/floor/wood/damturf/broken1,/area/ruin/lavaland/powered/animal_hospital)
"CQ" = (/obj/structure/flora/ausbushes/sparsegrass,/turf/open/floor/grass{initial_gas_mix = "o2=14;n2=23;TEMP=300"},/area/ruin/lavaland/powered/animal_hospital)
"DW" = (/obj/structure/flora/ausbushes/sunnybush,/turf/open/floor/grass{initial_gas_mix = "o2=14;n2=23;TEMP=300"},/area/ruin/lavaland/powered/animal_hospital)
"Fr" = (/obj/structure/bed/badhaybed,/turf/open/floor/plating/dirt/jungle,/area/ruin/lavaland/powered/animal_hospital)
"GD" = (/turf/open/floor/wood/damturf/broken7,/area/ruin/lavaland/powered/animal_hospital)
"HS" = (/turf/open/floor/grass{initial_gas_mix = "o2=14;n2=23;TEMP=300"},/area/ruin/lavaland/powered/animal_hospital)
"IA" = (/turf/open/water/jungle,/area/ruin/lavaland/powered/animal_hospital)
"LS" = (/obj/structure/sink/kitchen{pixel_y = 20},/turf/open/floor/plating/dirt/jungle,/area/ruin/lavaland/powered/animal_hospital)
"MI" = (/turf/open/floor/wood/damturf/broken3,/area/ruin/lavaland/powered/animal_hospital)
"MR" = (/obj/item/reagent_containers/glass/bucket/wood{pixel_y = -8; pixel_x = 8},/turf/open/floor/wood,/area/ruin/lavaland/powered/animal_hospital)
"Na" = (/turf/open/floor/wood/damturf/broken1,/area/ruin/lavaland/powered/animal_hospital)
"OC" = (/obj/item/stack/sheet/hay/five{pixel_x = 6; pixel_y = 9},/obj/structure/fluff/railing{dir = 8},/obj/item/reagent_containers/food/snacks/grown/grass,/turf/open/floor/plating/dirt/jungle,/area/ruin/lavaland/powered/animal_hospital)
"Qc" = (/obj/structure/fluff/railing{dir = 4},/turf/open/floor/plating/dirt/jungle,/area/ruin/lavaland/powered/animal_hospital)
"Rc" = (/obj/structure/closet/crate/critter,/turf/open/floor/wood,/area/ruin/lavaland/powered/animal_hospital)
"Rl" = (/obj/item/stack/sheet/hay/five{pixel_x = -30},/obj/structure/fluff/railing{dir = 4},/turf/open/floor/plating/dirt/jungle,/area/ruin/lavaland/powered/animal_hospital)
"Sn" = (/obj/item/flashlight/lantern{anchored = 1; icon_state = "lantern-on"; on = 1},/turf/open/floor/grass{initial_gas_mix = "o2=14;n2=23;TEMP=300"},/area/ruin/lavaland/powered/animal_hospital)
"ST" = (/obj/structure/flora/ausbushes/sparsegrass,/turf/open/floor/plating/dirt/jungle,/area/ruin/lavaland/powered/animal_hospital)
"Td" = (/obj/structure/mineral_door/woodrustic,/obj/structure/barricade/wooden,/turf/open/floor/wood,/area/ruin/lavaland/powered/animal_hospital)
"Tn" = (/obj/item/stack/sheet/hay/ten,/obj/structure/rack/shelf,/obj/item/reagent_containers/glass/bucket/wood,/obj/item/clothing/mask/cowmask/gag{pixel_y = -8},/turf/open/floor/wood,/area/ruin/lavaland/powered/animal_hospital)
"Ue" = (/obj/machinery/light{dir = 1},/turf/open/floor/plating/dirt/jungle,/area/ruin/lavaland/powered/animal_hospital)
"UR" = (/obj/structure/fluff/railing{dir = 8},/turf/open/floor/plating/dirt/jungle,/area/ruin/lavaland/powered/animal_hospital)
"Vx" = (/obj/structure/mineral_door/woodrustic,/turf/open/floor/wood,/area/ruin/lavaland/powered/animal_hospital)
"VP" = (/obj/item/reagent_containers/glass/bucket/wood{pixel_y = 8; pixel_x = 12},/turf/open/floor/wood,/area/ruin/lavaland/powered/animal_hospital)
"WG" = (/obj/structure/chair/comfy/plywood,/obj/item/gun/ballistic/shotgun/boltaction,/obj/item/clothing/head/cowboyhat/white,/turf/open/floor/plating/dirt/jungle,/area/ruin/lavaland/powered/animal_hospital)
"WK" = (/obj/structure/sink/well,/turf/open/floor/grass{initial_gas_mix = "o2=14;n2=23;TEMP=300"},/area/ruin/lavaland/powered/animal_hospital)
"Xz" = (/obj/structure/bed/badhaybed,/turf/open/floor/wood/damturf/broken2,/area/ruin/lavaland/powered/animal_hospital)
"XW" = (/turf/closed/mineral/volcanic/lava_land_surface,/area/lavaland/surface/outdoors)

(1,1,1) = {"
fFfFfFfFfFfFfFfFfFfFfFfFfFfFfFfFfFfFfFfFfFfF
fFfFfFfFfFfFXWXWXWXWXWXWXWfFfFfFfFfFfFfFfFfF
fFfFfFfFXWXWmymymymymymyXWXWfFfFfFfFfFfFfFfF
fFfFfFfFXWXWmyytsapATnmyXWXWXWfFfFfFfFfFfFfF
fFfFfFXWXWXWmyRcGDMIjsmyXWXWXWXWfFfFfFfFfFfF
fFfFXWXWXWmymymyVxBemymymyXWXWXWXWXWfFfFfFfF
fFfFXWXWXWmyFrhkjsjsURFrmyXWhaXWXWXWXWfFfFfF
fFXWXWXWXWmycuRlMIVPURfomyXWmtmtXWXWXWfFfFfF
fFXWXWXWXWmyAKQcjsGDOCFrmyXWXWIAmtXWXWXWfFfF
fFXWXWXWXWmymymyVxVxmymymyXWIAIAIAXWXWXWfFfF
fFXWXWXWSTUelwWGAiAiLSpPUeAilwSTIAXWXWXWfFfF
fFXWXWAiAiDWAiAiAiAiAiCQHSSTAiatSTXWXWXWfFfF
fFXWXWAiktCQHSlwAiAivJHSDWAfAiAiAiXWXWXWfFfF
fFXWXWXWcBHSvJHSHSCQHSHSHSHSktHSXWXWXWXWfFfF
fFXWXWXWXWqMHSHSktHSHSSnWKHSCQXWXWXWXWfFfFfF
fFXWXWXWXWCQDWHSHSCQHSktHSHSXWXWXWXWXWfFfFfF
fFXWXWXWXWXWkttXHSHSHSwtHSXWXWXWXWXWfFfFfFfF
fFXWXWXWXWXWXWmylEmyTdmyXWXWXWXWXWXWfFfFfFfF
fFfFXWXWXWXWXWmyjsXzjsmyXWXWXWXWXWXWfFfFfFfF
fFfFXWXWXWXWXWmyoAjsMRmyXWXWXWXWXWfFfFfFfFfF
fFfFXWXWXWXWXWmygINajsmyXWXWXWXWXWfFfFfFfFfF
fFfFfFXWXWXWXWmyjsgSbLmyXWXWXWXWfFfFfFfFfFfF
fFfFfFfFfFXWXWmynqmynqmyXWXWfFfFfFfFfFfFfFfF
fFfFfFfFfFxHxHxHxHxHxHxHxHxHfFfFfFfFfFfFfFfF
fFfFfFfFfFfFxHxHxHxHxHxHxHfFfFfFfFfFfFfFfFfF
"}
